81,9,431,9,431,36,81,36,
659,9,847,9,847,29,659,29,
0,0,0,0,0,0,0,0,
70,41,389,41,389,72,70,72,
661,41,801,41,801,62,661,62,
0,0,0,0,0,0,0,0,
412,79,603,79,603,98,412,98,
660,79,883,79,883,100,660,100,
123,79,403,79,403,111,123,111,
1,95,37,95,37,124,1,124,
318,113,691,113,691,146,318,146,
782,113,935,113,935,142,782,142,
682,153,769,153,769,175,682,175,
0,0,0,0,0,0,0,0,
74,152,363,152,363,183,74,183,
206,185,351,185,351,207,206,207,
682,185,762,185,762,207,682,207,
76,185,172,185,172,207,76,207,
3,185,15,185,15,202,3,202,
0,0,0,0,0,0,0,0,
73,213,386,213,386,235,73,235,
566,213,805,213,805,234,566,234,
19,241,42,241,42,263,19,263,
77,241,149,241,149,262,77,262,
164,241,917,241,917,266,164,266,
70,271,892,271,892,301,70,301,
5,271,34,271,34,290,5,290,
179,301,863,301,863,332,179,332,
8,320,40,320,40,341,8,341,
183,332,932,332,932,359,183,359,
181,359,474,359,474,386,181,386,
69,386,296,386,296,412,69,412,
17,386,37,386,37,414,17,414,
80,420,124,420,124,441,80,441,
839,420,926,420,926,444,839,444,
749,420,799,420,799,437,749,437,
317,420,542,420,542,444,317,444,
21,420,38,420,38,440,21,440,
21,453,35,453,35,475,21,475,
140,453,560,453,560,476,140,476,
94,487,106,487,106,500,94,500,
871,487,898,487,898,507,871,507,
751,487,797,487,797,504,751,504,
139,487,347,487,347,508,139,508,
139,512,345,512,345,533,139,533,
138,537,463,537,463,560,138,560,
97,537,108,537,108,555,97,555,
875,537,902,537,902,558,875,558,
753,537,800,537,800,555,753,555,
140,564,280,564,280,585,140,585,
4,588,31,588,31,612,4,612,
138,588,510,588,510,610,138,610,
95,588,106,588,106,606,95,606,
877,588,904,588,904,609,877,609,
754,588,801,588,801,606,754,606,
136,616,235,616,235,635,136,635,
3,616,27,616,27,638,3,638,
59,643,240,643,240,668,59,668,
52,675,560,675,560,702,52,702,
655,708,925,708,925,735,655,735,
105,732,185,732,185,762,105,762,
472,732,589,732,589,756,472,756,
287,732,373,732,373,754,287,754,
731,739,870,739,870,760,731,760,
434,767,633,767,633,791,434,791,
693,767,896,767,896,789,693,789,
479,811,561,811,561,854,479,854,
510,857,582,857,582,919,510,919,
554,920,565,920,565,941,554,941,
705,920,889,920,889,947,705,947,
435,956,701,956,701,1048,435,1048,
