80,44,749,44,749,94,80,94,
896,44,1078,44,1078,138,896,138,
160,99,645,99,645,153,160,153,
197,153,327,153,327,180,197,180,
1181,153,1514,153,1514,185,1181,185,
136,153,202,153,202,182,136,182,
119,182,682,182,682,254,119,254,
1186,205,1434,205,1434,241,1186,241,
769,261,835,261,835,287,769,287,
1184,261,1574,261,1574,298,1184,298,
826,261,1077,261,1077,285,826,285,
581,325,1236,325,1236,376,581,376,
1405,325,1668,325,1668,366,1405,366,
137,384,676,384,676,429,137,429,
1216,384,1370,384,1370,423,1216,423,
137,444,315,444,315,484,137,484,
373,444,634,444,634,484,373,484,
1225,444,1328,444,1328,475,1225,475,
129,496,696,496,696,535,129,535,
1012,496,1440,496,1440,528,1012,528,
126,541,1135,541,1135,579,126,579,
120,589,1649,589,1649,643,120,643,
325,643,1646,643,1646,694,325,694,
322,694,1583,694,1583,748,322,748,
129,748,540,748,540,797,129,797,
146,808,224,808,224,838,146,838,
1509,808,1664,808,1664,850,1509,850,
565,808,968,808,968,850,565,850,
1345,808,1432,808,1432,839,1345,839,
248,877,777,877,777,921,248,921,
185,877,196,877,196,906,185,906,
1358,877,1419,877,1419,909,1358,909,
1563,877,1609,877,1609,913,1563,913,
256,928,595,928,595,963,256,963,
247,968,913,968,913,1011,247,1011,
174,968,194,968,194,997,174,997,
1571,968,1617,968,1617,1004,1571,1004,
1353,968,1436,968,1436,1001,1353,1001,
251,1016,376,1016,376,1051,251,1051,
243,1056,839,1056,839,1101,243,1101,
173,1056,191,1056,191,1086,173,1086,
1571,1056,1619,1056,1619,1091,1571,1091,
1358,1056,1439,1056,1439,1090,1358,1090,
245,1107,360,1107,360,1143,245,1143,
245,1149,697,1149,697,1189,245,1189,
167,1149,188,1149,188,1180,167,1180,
1574,1149,1621,1149,1621,1185,1574,1185,
1358,1149,1442,1149,1442,1181,1358,1181,
254,1197,390,1197,390,1232,254,1232,
235,1237,881,1237,881,1291,235,1291,
168,1237,188,1237,188,1268,168,1268,
1358,1237,1441,1237,1441,1269,1358,1269,
1576,1237,1622,1237,1622,1274,1576,1274,
243,1293,335,1293,335,1330,243,1330,
238,1339,643,1339,643,1380,238,1380,
164,1339,183,1339,183,1371,164,1371,
1582,1339,1629,1339,1629,1377,1582,1377,
1361,1339,1444,1339,1444,1371,1361,1371,
232,1384,338,1384,338,1428,232,1428,
102,1443,427,1443,427,1484,102,1484,
87,1502,1006,1502,1006,1555,87,1555,
1181,1565,1665,1565,1665,1607,1181,1607,
185,1608,330,1608,330,1650,185,1650,
512,1608,667,1608,667,1644,512,1644,
848,1608,1061,1608,1061,1649,848,1649,
1315,1608,1539,1608,1539,1641,1315,1641,
772,1667,1136,1667,1136,1713,772,1713,
1244,1667,1612,1667,1612,1707,1244,1707,
801,1734,950,1734,950,1831,801,1831,
845,1864,865,1864,865,1893,845,1893,
993,1864,1184,1864,1184,1958,993,1958,
873,1958,1015,1958,1015,2034,873,2034,
816,2034,889,2034,889,2154,816,2154,
1328,1965,1531,1965,1531,2004,1328,2004,
