180,203,786,203,786,249,180,249,
1205,259,1507,259,1507,286,1205,286,
272,259,703,259,703,312,272,312,
1208,309,1429,309,1429,340,1208,340,
260,320,683,320,683,347,260,347,
236,347,719,347,719,396,236,396,
812,347,948,347,948,375,812,375,
1205,347,1557,347,1557,382,1205,382,
657,411,1252,411,1252,465,657,465,
1400,411,1653,411,1653,456,1400,456,
264,480,707,480,707,521,264,521,
1241,480,1380,480,1380,513,1241,513,
270,529,427,529,427,566,270,566,
477,529,708,529,708,562,477,562,
1241,529,1333,529,1333,555,1241,555,
261,573,763,573,763,609,261,609,
1050,573,1436,573,1436,602,1050,602,
259,613,1514,613,1514,656,259,656,
256,656,1623,656,1623,709,256,709,
439,709,1107,709,1107,747,439,747,
269,747,632,747,632,788,269,788,
286,808,355,808,355,835,286,835,
1342,808,1422,808,1422,835,1342,835,
1494,808,1634,808,1634,846,1494,846,
652,808,1009,808,1009,849,652,849,
366,867,969,867,969,912,366,912,
323,867,333,867,333,892,323,892,
1347,867,1422,867,1422,897,1347,897,
1544,867,1586,867,1586,898,1544,898,
372,918,508,918,508,955,372,955,
376,957,1153,957,1153,992,376,992,
312,995,330,995,330,1022,312,1022,
1350,995,1427,995,1427,1025,1350,1025,
1546,995,1588,995,1588,1028,1546,1028,
372,995,771,995,771,1040,372,1040,
368,1040,589,1040,589,1078,368,1078,
260,1083,540,1083,540,1119,260,1119,
245,1133,1039,1133,1039,1177,245,1177,
1187,1186,1615,1186,1615,1229,1187,1229,
338,1227,461,1227,461,1263,338,1263,
613,1227,747,1227,747,1254,613,1254,
905,1227,1089,1227,1089,1261,905,1261,
1310,1232,1507,1232,1507,1266,1310,1266,
835,1277,1151,1277,1151,1313,835,1313,
1244,1277,1566,1277,1566,1313,1244,1313,
327,1355,412,1355,412,1460,327,1460,
1228,1487,1390,1487,1390,1572,1228,1572,
1307,1572,1497,1572,1497,1614,1307,1614,
949,1611,1220,1611,1220,1752,949,1752,
841,1752,1014,1752,1014,1830,841,1830,
218,2357,1153,2357,1153,2396,218,2396,
